Employee ID,Employee Name,Total Hours Worked,Gross Pay,Tax,Net Pay
1,John Smith,40,50000,15000,35000
2,Jane Doe,35,45000,13500,31500
3,Mark Johnson,40,50000,15000,35000
4,Sarah Davis,30,40000,12000,28000
5,Michael Brown,38,48000,14400,33600
6,Emily Wilson,42,52000,15600,36400
7,David Taylor,36,46000,13800,32200
8,Amy Clark,41,51000,15300,35700
9,Christopher Martinez,39,49000,14700,34300
10,Megan Thompson,37,47000,14100,32900